1111111111111111111111111111111111
1000C000000000000000000000000C0001
10100101001000001010010000C0010101
101001001011010100100100E000010101
100000000C000000000000000000000001
1000000000001110000100000CP0000001
10011100000C0000000100000000000001
1000000000000111000100000000000001
100000000C000000000000C00000000001
1111111111111111111111111111111111