111111111111111111111
100010C00000000000001
10001110000010C000001
1P0000000010000000001
100100000001C00000001
101C100000010000C0001
100000000001000000001
100001C10001000000001
1E0001111111111111111
10000010C000000000001
1000001000000000C0001
100000100000000000001
100000100000000000001
100000100000000000001
100000100010000000001
100000001010000000001
100000000010000000001
100000000010000000001
100C00000100000000001
100000000100000000001
100000001000000000001
10000001000000C000001
100000000000000000001
111111111111111111111