111111111111
100P0C000E01
111111111111