111111111111111111111111
100P00000C0000000E000001
111111111111111111111110